Date,Trips over the past 24-hours (midnight to 11:59pm),Cumulative trips (since launch):,,Miles traveled today (midnight to 11:59 pm),Miles traveled to date:,Total Annual Members (All Time),24-Hour Passes Purchased (midnight to 11:59 pm),3-Day Passes Purchased (midnight to 11:59 pm),7-Day Passes Purchased (midnight to 11:59 pm)
1/1/2015,5792,"15,216,843",,9191,26055797,127279,267,,11
1/2/2015,12371,"15,229,214",0,18222,26074019,127293,298,,8
1/3/2015,4834,"15,234,048",0,6282,26080301,127300,96,,7
1/4/2015,8509,"15,242,557",0,11700,26092001,127308,152,,5
1/5/2015,15792,"15,258,349",0,20022,26112023,127336,88,,12
1/6/2015,9483,"15,267,832",0,12003,26124026,127354,2,,1
1/7/2015,10685,"15,278,517",0,12791,26136817,127363,5,,1
1/8/2015,9777,"15,288,294",0,11667,26148484,127372,18,,0
1/9/2015,8631,"15,296,925",0,11093,26159577,127376,16,,2
1/10/2015,6826,"15,303,751",0,8189,26167766,127383,51,,3
1/11/2015,8204,"15,311,955",0,10199,26177965,127395,68,,8
1/12/2015,9441,"15,321,396",0,11589,26189554,127408,27,,2
1/13/2015,14134,"15,335,530",0,17429,26206983,127418,23,,10
1/14/2015,14396,"15,349,926",0,18105,26225088,127427,43,,7
1/15/2015,15463,"15,365,389",0,19803,26244891,127434,64,,8
1/16/2015,15059,"15,380,448",0,19084,26263975,127441,94,,14
1/17/2015,8243,"15,388,691",0,10818,26274793,127453,152,,3
1/18/2015,2038,"15,390,729",0,2435,26277228,127461,12,,0
1/19/2015,11913,"15,402,642",0,15733,26292961,127470,124,,11
1/20/2015,17615,"15,420,257",0,22740,26315701,127502,93,,9
1/21/2015,16734,"15,436,991",0,21228,26336929,127520,67,,16
1/22/2015,17435,"15,454,426",0,22630,26359559,127530,74,,9
1/23/2015,17080,"15,471,506",0,22248,26381807,127545,95,,14
1/24/2015,5275,"15,476,781",0,6723,26388530,127552,41,,2
1/25/2015,10235,"15,487,016",0,14421,26402951,127559,202,,4
1/26/2015,4537,"15,491,553",0,5979,26408930,127566,15,,0
1/27/2015,1405,"15,492,958",0,2343,26411273,127569,36,,1
1/28/2015,6223,"15,499,181",0,9907,26421180,127575,12,,2
1/29/2015,9845,"15,509,026",0,14171,26435351,127586,31,,3
1/30/2015,9943,"15,518,969",0,12945,26448296,127595,21,,6
1/31/2015,5752,"15,524,721",0,7328,26455624,127596,38,,2
2/1/2015,7214,"15,531,935",0,9186,26464810,127608,72,,8
2/2/2015,1686,"15,533,621",0,2635,26467445,127608,6,,0
2/3/2015,5443,"15,539,064",0,7816,26475261,127612,5,,1
2/4/2015,9854,"15,548,918",0,13775,26489036,127624,27,,1
2/5/2015,9977,"15,558,895",0,12607,26501643,127630,13,,1
2/6/2015,9334,"15,568,229",0,11948,26513591,127635,26,,4
2/7/2015,7346,"15,575,575",0,10045,26523636,127640,83,,7
2/8/2015,7180,"15,582,755",0,9671,26533307,127642,65,,7
2/9/2015,5717,"15,588,472",0,7234,26540541,127646,10,,3
2/10/2015,11289,"15,599,761",0,14526,26555067,127652,36,,5
2/11/2015,12453,"15,612,214",0,16204,26571271,127657,46,,12
2/12/2015,12651,"15,624,865",0,16248,26587519,127667,45,,4
2/13/2015,8595,"15,633,460",0,10773,26598292,127674,28,,2
2/14/2015,5124,"15,638,584",0,6392,26604684,127678,54,,2
2/15/2015,2837,"15,641,421",0,3289,26607973,127681,12,,0
2/16/2015,4500,"15,645,921",0,5423,26613396,127682,19,,2
2/17/2015,5289,"15,651,210",0,6869,26620265,127683,14,,2
2/18/2015,10001,"15,661,211",0,12995,26633260,127693,35,,6
2/19/2015,8485,"15,669,696",0,10080,26643340,127696,14,,0
2/20/2015,6825,"15,676,521",0,8056,26651396,127700,14,,3
2/21/2015,3453,"15,679,974",0,4164,26655560,127701,24,,5
2/22/2015,4654,"15,684,628",0,6648,26662208,127706,55,,4
2/23/2015,8343,"15,692,971",0,10519,26672727,127714,11,,8
2/24/2015,8483,"15,701,454",0,10675,26683402,127729,12,,1
2/25/2015,12057,"15,713,511",0,15655,26699057,127739,49,,5
2/26/2015,11047,"15,724,558",0,14744,26713801,127747,26,,7
2/27/2015,10861,"15,735,419",0,14313,26728114,127753,57,,10
2/28/2015,6836,"15,742,255",0,8975,26737089,127754,71,,3
3/1/2015,3169,"15,745,424",0,4042,26741131,127763,37,,4
3/2/2015,8019,"15,753,443",0,10767,26751898,127770,27,,3
3/3/2015,7178,"15,760,621",0,9430,26761328,127775,18,,2
3/4/2015,8265,"15,768,886",0,10842,26772170,127779,28,,4
3/5/2015,1821,"15,770,707",0,2604,26774774,127784,4,,0
3/6/2015,5953,"15,776,660",0,8248,26783022,127792,19,,6
3/7/2015,6255,"15,782,915",0,8849,26791871,127799,96,,9
3/8/2015,8711,"15,791,626",0,13701,26805572,127819,245,,16
3/9/2015,16365,"15,807,991",0,24159,26829731,127852,218,,24
3/10/2015,13080,"15,821,071",0,17626,26847357,127886,126,,17
3/11/2015,21728,"15,842,799",0,33446,26880803,127936,386,,29
3/12/2015,19246,"15,862,045",0,26931,26907734,127977,195,,22
3/13/2015,17850,"15,879,895",0,24699,26932433,128023,239,,27
3/14/2015,4302,"15,884,197",0,5592,26938025,128041,60,,5
3/15/2015,9676,"15,893,873",0,13635,26951660,128071,260,,31
3/16/2015,18476,"15,912,349",0,26091,26977751,128108,273,,35
3/17/2015,16287,"15,928,636",0,22462,27000213,128143,178,,21
3/18/2015,15050,"15,943,686",0,11465,27011678,128169,110,,15
3/19/2015,16699,"15,960,385",0,16176,27027854,128191,150,,14
3/20/2015,8786,"15,969,171",0,11465,27039319,128204,58,,6
3/21/2015,10236,"15,979,407",0,16176,27055495,128216,367,,23
3/22/2015,10638,"15,990,045",0,16098,27071593,128249,381,,10
3/23/2015,14669,"16,004,714",0,18957,27090550,128287,111,,25
3/24/2015,17532,"16,022,246",0,23581,27114131,128313,168,,34
3/25/2015,15851,"16,038,097",0,21456,27135587,128347,136,,22
3/26/2015,16193,"16,054,290",0,22876,27158463,128385,125,,25
3/27/2015,15433,"16,069,723",0,21520,27179983,128417,188,,19
3/28/2015,1255,"16,070,978",0,1562,27181545,128431,10,,2
3/29/2015,10585,"16,081,563",0,17373,27198918,128485,473,,27
3/30/2015,19250,"16,100,813",0,26828,27225746,128527,244,,53
3/31/2015,15199,"16,116,012",0,20532,27246278,128576,122,,38
4/1/2015,21566,"16,137,578",0,31708,27277986,128629,325,,34
4/2/2015,26346,"16,163,924",0,43134,27321120,128698,864,,65
4/3/2015,15978,"16,179,902",0,23643,27344763,128735,365,,27
4/4/2015,15538,"16,195,440",0,27764,27372527,128783,1029,,46
4/5/2015,14962,"16,210,402",0,29709,27402236,128846,1208,,52
4/6/2015,25502,"16,235,904",0,43529,27445765,128940,1065,,73
4/7/2015,17640,"16,253,544",0,24209,27469974,129003,270,,33
4/8/2015,19223,"16,272,767",0,26004,27495978,129047,276,,30
4/9/2015,17723,"16,290,490",0,23891,27519869,129081,163,,20
4/10/2015,17648,"16,308,138",0,25628,27545497,129124,289,,37
4/11/2015,20451,"16,328,589",0,39786,27585283,129193,1600,,59
4/12/2015,21851,"16,350,440",0,46764,27632047,129273,1951,,87
4/13/2015,26980,"16,377,420",0,43753,27675800,129377,603,,73
4/14/2015,24452,"16,401,872",0,36555,27712355,129451,334,,53
4/15/2015,30184,"16,432,056",0,49727,27762082,129541,733,,84
4/16/2015,29273,"16,461,329",0,45915,27807997,129639,617,,57
4/17/2015,26164,"16,487,493",0,42203,27850200,129717,671,,81
4/18/2015,31024,"16,518,517",0,71371,27921571,129802,3685,,138
4/19/2015,23444,"16,541,961",0,46416,27967987,129901,1851,,103
4/20/2015,12080,"16,554,041",0,16377,27984364,129974,96,,23
4/21/2015,27057,"16,581,098",0,43508,28027872,130039,608,,88
4/22/2015,23893,"16,604,991",0,35999,28063871,130109,374,,51
4/23/2015,23886,"16,628,877",0,34259,28098130,130168,311,,61
4/24/2015,22605,"16,651,482",0,32678,28130808,130211,421,,37
4/25/2015,22963,"16,674,445",0,46054,28176862,130293,2095,,85
4/26/2015,23608,"16,698,053",0,48664,28225526,130378,1999,,128
4/27/2015,27657,"16,725,710",0,43197,28268723,130486,609,,99
4/28/2015,32481,"16,758,191",0,54129,28322852,130575,893,,98
4/29/2015,34427,"16,792,618",0,59166,28382018,130671,1087,,150
4/30/2015,31756,"16,824,374",0,51077,28433095,130745,785,,102
5/1/2015,30345,"16,854,719",0,48736,28481831,130840,917,,106
5/2/2015,28295,"16,883,014",0,60188,28542019,130899,2799,,138
5/3/2015,30446,"16,913,460",0,69728,28611747,130992,3361,,154
5/4/2015,35115,"16,948,575",0,63531,28675278,131145,1397,,191
5/5/2015,35990,"16,984,565",0,60088,28735366,131284,987,,145
5/6/2015,32788,"17,017,353",0,50987,28786353,131366,712,,90
5/7/2015,37762,"17,055,115",0,64189,28850542,131496,1271,,133
5/8/2015,37206,"17,092,321",0,64255,28914797,131607,1596,,170
5/9/2015,26813,"17,119,134",0,51941,28966738,131677,2077,,158
5/10/2015,28962,"17,148,096",0,62364,29029102,131752,2444,,189
5/11/2015,35068,"17,183,164",0,57873,29086975,131884,1084,,198
5/12/2015,38186,"17,221,350",0,62939,29149914,131979,1103,,179
5/13/2015,36162,"17,257,512",0,57091,29207005,132074,891,,119
5/14/2015,44429,"17,301,941",0,80286,29287291,132158,4927,,82
5/15/2015,37687,"17,339,628",0,64660,29351951,132225,1665,,181
5/16/2015,26142,"17,365,770",0,50862,29402813,132293,2392,,155
5/17/2015,34006,"17,399,776",0,73458,29476271,132357,3499,,189
5/18/2015,33527,"17,433,303",0,53794,29530065,132470,1031,,129
5/19/2015,36272,"17,469,575",0,58026,29588091,132561,943,,177
5/20/2015,36020,"17,505,595",0,57290,29645381,132643,923,,100
5/21/2015,33076,"17,538,671",0,50277,29695658,132711,746,,105
5/22/2015,33898,"17,572,569",0,58351,29754009,132765,1356,,150
5/23/2015,25985,"17,598,554",0,56999,29811008,132798,2967,,166
5/24/2015,27400,"17,625,954",0,66211,29877219,132839,3689,,156
5/25/2015,30636,"17,656,590",0,69099,29946318,132914,3392,,221
5/26/2015,38282,"17,694,872",0,64504,30010822,133006,1202,,188
5/27/2015,35952,"17,730,824",0,57511,30068333,133080,879,,124
5/28/2015,38291,"17,769,115",0,61662,30129995,133153,1014,,144
5/29/2015,40179,"17,809,294",0,69343,30199338,133217,1648,,134
5/30/2015,33503,"17,842,797",0,69481,30268819,133265,3082,,192
5/31/2015,21196,"17,863,993",0,40580,30309399,133339,1606,,105
6/1/2015,16079,"17,880,072",0,20369,30329768,133401,162,,41
6/2/2015,12706,"17,892,778",0,15730,30345498,133453,75,,35
6/3/2015,36345,"17,929,123",0,58749,30404247,133535,1129,,143
6/4/2015,34390,"17,963,513",0,52792,30457039,133598,806,,147
6/5/2015,32861,"17,996,374",0,51079,30508118,133641,959,,117
6/6/2015,27910,"18,024,284",0,55613,30563731,133687,2457,,144
6/7/2015,32881,"18,057,165",0,71994,30635725,133752,3295,,169
6/8/2015,35453,"18,092,618",0,58140,30693865,133832,1045,,168
6/9/2015,37322,"18,129,940",0,59489,30753354,133896,889,,140
6/10/2015,41386,"18,171,326",0,69035,30822389,133964,1223,,140
6/11/2015,39083,"18,210,409",0,62993,30885382,134041,1060,,137
6/12/2015,36801,"18,247,210",0,60933,30946315,134109,1374,,131
6/13/2015,31772,"18,278,982",0,67103,31013418,134156,3045,,168
6/14/2015,29829,"18,308,811",0,62977,31076395,134220,2633,,192
6/15/2015,26533,"18,335,344",0,38705,31115100,134279,575,,122
6/16/2015,33832,"18,369,176",0,52864,31167964,134345,798,,151
6/17/2015,40009,"18,409,185",0,65208,31233172,134414,1145,,160
6/18/2015,37326,"18,446,511",0,56562,31289734,134468,792,,144
6/19/2015,39350,"18,485,861",0,66914,31356648,134516,1543,,143
6/20/2015,24937,"18,510,798",0,45872,31402520,134548,1747,,125
6/21/2015,27486,"18,538,284",0,55513,31458033,134602,2295,,140
6/22/2015,39758,"18,578,042",0,66659,31524692,134676,1282,,202
6/23/2015,34182,"18,612,224",0,52805,31577497,134743,824,,147
6/24/2015,43484,"18,655,708",0,73125,31650622,134818,1270,,189
6/25/2015,41618,"18,697,326",0,68362,31718984,134859,1166,,135
6/26/2015,40599,"18,737,925",0,68529,31787513,134908,1579,,182
6/27/2015,16271,"18,754,196",0,28233,31815746,134935,1143,,65
6/28/2015,21588,"18,775,784",0,42273,31858019,134975,1610,,101
6/29/2015,39785,"18,815,569",0,69309,31927328,135065,1452,,196
6/30/2015,39839,"18,855,408",0,65564,31992892,135136,1220,,156
7/1/2015,39019,"18,894,427",0,64472,32057364,135204,1251,,142
7/2/2015,36962,"18,931,389",0,62434,32119798,135247,1411,,175
7/3/2015,27821,"18,959,210",0,58884,32178682,135294,2818,,173
7/4/2015,22347,"18,981,557",0,53110,32231792,135326,3036,,130
7/5/2015,26708,"19,008,265",0,61185,32292977,135384,2829,,180
7/6/2015,36174,"19,044,439",0,62539,32355516,135470,1287,,224
7/7/2015,37930,"19,082,369",0,63163,32418679,135548,1071,,200
7/8/2015,35900,"19,118,269",0,57751,32476430,135594,823,,139
7/9/2015,32734,"19,151,003",0,52402,32528832,135646,900,,122
7/10/2015,39687,"19,190,690",0,71490,32600322,135704,1724,,143
7/11/2015,32620,"19,223,310",0,69705,32670027,135755,3190,,178
7/12/2015,31853,"19,255,163",0,68158,32738185,135809,2875,,166
7/13/2015,39586,"19,294,749",0,67998,32806183,135890,1273,,238
7/14/2015,36671,"19,331,420",0,58900,32865083,135966,754,,145
7/15/2015,35855,"19,367,275",0,57781,32922864,136023,873,,111
7/16/2015,43302,"19,410,577",0,76535,32999399,136092,1676,,197
7/17/2015,40782,"19,451,359",0,73884,33073283,136144,1815,,161
7/18/2015,29619,"19,480,978",0,61739,33135022,136188,2800,,165
7/19/2015,29332,"19,510,310",0,61512,33196534,136244,2709,,169
7/20/2015,35960,"19,546,270",0,59568,33256102,136315,1052,,205
7/21/2015,39557,"19,585,827",0,66191,33322293,136379,1234,,170
7/22/2015,43602,"19,629,429",0,75758,33398051,136460,1363,,179
7/23/2015,43319,"19,672,748",0,75512,33473563,136528,1404,,166
7/24/2015,41201,"19,713,949",0,72841,33546404,136594,1778,,174
7/25/2015,32458,"19,746,407",0,73133,33619537,136655,3535,,148
7/26/2015,31325,"19,777,732",0,66278,33685815,136721,2889,,171
7/27/2015,39602,"19,817,334",0,67841,33753656,136818,1232,,230
7/28/2015,41321,"19,858,655",0,69131,33822787,136901,1245,,181
7/29/2015,40267,"19,898,922",0,66299,33889086,136979,1085,,153
7/30/2015,31878,"19,930,800",0,50297,33939383,137044,785,,108
7/31/2015,39360,"19,970,160",0,69897,34009280,137109,1723,,177
8/1/2015,36088,"20,006,248",0,84287,34093567,137654,4286,,234
8/2/2015,32482,"20,038,730",0,72633,34166200,137738,3189,,204
8/3/2015,39912,"20,078,642",0,69232,34235432,137833,1400,,230
8/4/2015,41672,"20,120,314",0,71146,34306578,137913,1393,,168
8/5/2015,42149,"20,162,463",0,71111,34377689,138024,1357,,160
8/6/2015,43455,"20,205,918",0,74669,34452358,138142,1498,,170
8/7/2015,41967,"20,247,885",0,74844,34527202,138224,1862,,154
8/8/2015,39866,"20,287,751",0,95931,34623133,138366,5101,,205
8/9/2015,33654,"20,321,405",0,78144,34701277,138455,3425,,177
8/10/2015,40718,"20,362,123",0,74754,34776031,138644,1518,,228
8/11/2015,25692,"20,387,815",0,42534,34818565,138756,622,,107
8/12/2015,44145,"20,431,960",0,80366,34898931,138895,1458,,196
8/13/2015,43174,"20,475,134",0,78784,34977715,139042,1479,,155
8/14/2015,40903,"20,516,037",0,72319,35050034,139172,1778,,195
8/15/2015,38777,"20,554,814",0,92390,35142424,139377,4773,,226
8/16/2015,30337,"20,585,151",0,65629,35208053,139514,2720,,179
8/17/2015,37446,"20,622,597",0,64425,35272478,139712,1285,,180
8/18/2015,39913,"20,662,510",0,67805,35340283,139882,1163,,158
8/19/2015,40721,"20,703,231",0,69834,35410117,140076,1266,,151
8/20/2015,39275,"20,742,506",0,66772,35476889,140222,1275,,140
8/21/2015,38033,"20,780,539",0,66202,35543091,140392,1572,,160
8/22/2015,34269,"20,814,808",0,77058,35620149,140516,3632,,190
8/23/2015,33059,"20,847,867",0,71456,35691605,140725,2960,,178
8/24/2015,38676,"20,886,543",0,68193,35759798,140971,1253,,182
8/25/2015,41052,"20,927,595",0,71734,35831532,141218,1224,,178
8/26/2015,42373,"20,969,968",0,73578,35905110,141423,1247,,159
8/27/2015,42801,"21,012,769",0,74735,35979845,141674,1333,,161
8/28/2015,41418,"21,054,187",0,74240,36054085,141943,1774,,160
8/29/2015,34053,"21,088,240",0,74840,36128925,142169,3470,,197
8/30/2015,32581,"21,120,821",0,68990,36197915,142496,2902,,189
8/31/2015,40043,"21,160,864",0,67836,36265751,143057,1197,,194
9/1/2015,43069,"21,203,933",0,72939,36338690,143239,1199,,185
9/2/2015,43004,"21,246,937",0,72983,36411673,143424,1244,,162
9/3/2015,42462,"21,289,399",0,71265,36482938,143581,1251,,193
9/4/2015,39572,"21,328,971",0,70681,36553619,143722,1843,,211
9/5/2015,33669,"21,362,640",0,77956,36631575,143854,4271,,228
9/6/2015,32875,"21,395,515",0,82123,36713698,143962,4571,,200
9/7/2015,33280,"21,428,795",0,75257,36788955,144160,3501,,155
9/8/2015,42344,"21,471,139",0,71591,36860546,144402,1138,,208
9/9/2015,43528,"21,514,667",0,71173,36931719,144617,1041,,175
9/10/2015,22023,"21,536,690",0,31862,36963581,144769,416,,77
9/11/2015,47206,"21,583,896",0,86598,37050179,144950,1929,,207
9/12/2015,33282,"21,617,178",0,68420,37118599,145145,2620,,192
9/13/2015,34308,"21,651,486",0,72749,37191348,145406,2814,,215
9/14/2015,44367,"21,695,853",0,83150,37274498,145619,1751,,240
9/15/2015,48402,"21,744,255",0,88238,37362736,145951,1533,,227
9/16/2015,50780,"21,795,035",0,91197,37453933,146279,1424,,199
9/17/2015,50275,"21,845,310",0,91433,37545366,146611,1508,,206
9/18/2015,49946,"21,895,256",0,95186,37640552,146874,2090,,226
9/19/2015,42653,"21,937,909",0,98568,37739120,1471994256,184,,undefined
9/20/2015,40099,"21,978,008",0,90483,37829603,147602,3598,,234
9/21/2015,47178,"22,025,186",0,85002,37914605,147960,1290,,249
9/22/2015,48664,"22,073,850",0,84251,37998856,148254,1080,,191
9/23/2015,48175,"22,122,025",0,88117,38086973,148522,1568,,218
9/24/2015,52706,"22,174,731",0,96872,38183845,148809,1766,,204
9/25/2015,51367,"22,226,098",0,95467,38279312,149055,2059,,193
9/26/2015,42559,"22,268,657",0,93740,38373052,149309,3769,,219
9/27/2015,38278,"22,306,935",0,82841,38455893,149566,2940,,151
9/28/2015,48009,"22,354,944",0,90180,38546073,149886,1505,,223
9/29/2015,48728,"22,403,672",0,87702,38633775,150277,1284,,173
9/30/2015,39450,"22,443,122",0,65081,38698856,150811,744,,77
10/1/2015,34719,"22,477,841",0,55662,38754518,150933,804,,92
10/2/2015,9444,"22,487,285",0,12111,38766629,150976,65,,4
10/3/2015,16564,"22,503,849",0,25241,38791870,151027,489,,64
10/4/2015,30214,"22,534,063",0,59317,38851187,151167,2005,,127
10/5/2015,44581,"22,578,644",0,78665,38929852,151361,1193,,176
10/6/2015,49720,"22,628,364",0,89905,39019757,151461,1328,,167
10/7/2015,50141,"22,678,505",0,89586,39109343,151579,1211,,172
10/8/2015,50179,"22,728,684",0,88959,39198302,151968,1436,,180
10/9/2015,37283,"22,765,967",0,65046,39263348,152132,1302,,97
10/10/2015,39348,"22,805,315",0,87575,39350923,152260,3864,,206
10/11/2015,38967,"22,844,282",0,92607,39443530,152421,4004,,171
10/12/2015,45584,"22,889,866",0,102884,39546414,153049,2452,,189
10/13/2015,49047,"22,938,913",0,101421,39647835,153382,1235,,151
10/14/2015,50000,"22,988,913",0,99751,39747586,153619,1069,,150
10/15/2015,48783,"23,037,696",0,96975,39844561,153784,1318,,155
10/16/2015,46486,"23,084,182",0,93266,39937827,153866,1522,,118
10/17/2015,31811,"23,115,993",0,70864,40008691,154026,2239,,120
10/18/2015,23978,"23,139,971",0,49590,40058281,154092,1141,,75
10/19/2015,36570,"23,176,541",0,66941,40125222,154422,661,,116
10/20/2015,45377,"23,221,918",0,89988,40215210,154499,1093,,147
10/21/2015,49121,"23,271,039",0,100309,40315519,154626,1339,,162
10/22/2015,49604,"23,320,643",0,100026,40415545,154799,1342,,177
10/23/2015,44681,"23,365,324",0,90710,40506255,154935,1429,,123
10/24/2015,31713,"23,397,037",0,71472,40577727,155028,2254,,101
10/25/2015,29289,"23,426,326",0,62798,40640525,155118,1761,,90
10/26/2015,42166,"23,468,492",0,81381,40721906,155296,1039,,154
10/27/2015,44553,"23,513,045",0,83174,40805080,155445,866,,86
10/28/2015,20736,"23,533,781",0,34040,40839120,155572,128,,25
10/29/2015,45359,"23,579,140",0,90367,40929487,155697,1179,,167
10/30/2015,44521,"23,623,661",0,90284,41019771,155873,1558,,154
10/31/2015,31759,"23,655,420",0,70082,41089853,156005,2206,,145
11/1/2015,30622,"23,686,042",0,66939,41156792,156096,2090,,111
11/2/2015,44534,"23,730,576",0,89099,41245891,156208,1316,,190
11/3/2015,49326,"23,779,902",0,100760,41346651,156301,1567,,166
11/4/2015,49487,"23,829,389",0,99144,41445795,156400,1217,,139
11/5/2015,43006,"23,872,395",0,81276,41527071,156499,849,,108
11/6/2015,47162,"23,919,557",0,95321,41622392,156561,1571,,122
11/7/2015,35586,"23,955,143",0,79866,41702258,156647,2643,,149
11/8/2015,32318,"23,987,461",0,73329,41775587,156743,2361,,99
11/9/2015,42262,"24,029,723",0,78410,41853997,156820,899,,102
11/10/2015,21585,"24,051,308",0,34847,41888844,156963,120,,42
11/11/2015,37705,"24,089,013",0,68696,41957540,157038,712,,95
11/12/2015,37319,"24,126,332",0,64556,42022096,157143,430,,61
11/13/2015,38970,"24,165,302",0,70190,42092286,157226,892,,78
11/14/2015,25300,"24,190,602",0,50403,42142689,157296,1349,,72
11/15/2015,25991,"24,216,593",0,54736,42197425,157392,1497,,78
11/16/2015,40916,"24,257,509",0,78389,42275814,157491,833,,105
11/17/2015,38939,"24,296,448",0,68151,42343965,157570,488,,66
11/18/2015,41486,"24,337,934",0,73030,42416995,157628,498,,82
11/19/2015,21890,"24,359,824",0,36884,42453879,157666,167,,37
11/20/2015,38205,"24,398,029",0,71192,42525071,157702,890,,73
11/21/2015,28038,"24,426,067",0,56288,42581359,157731,1572,,65
11/22/2015,23344,"24,449,411",0,44743,42626102,157781,905,,39
11/23/2015,30136,"24,479,547",0,51812,42677914,157830,382,,43
11/24/2015,32218,"24,511,765",0,53981,42731895,157870,392,,43
11/25/2015,30295,"24,542,060",0,55504,42787399,157893,636,,54
11/26/2015,13291,"24,555,351",0,35956,42823355,157907,1436,,61
11/27/2015,22829,"24,578,180",0,51342,42874697,157929,1859,,78
11/28/2015,15832,"24,594,012",0,32196,42906893,157952,1061,,45
11/29/2015,18453,"24,612,465",0,36854,42943747,157997,888,,45
11/30/2015,30221,"24,642,686",0,52674,42996421,158047,346,,62
12/1/2015,18399,"24,661,085",0,29273,43025694,158067,61,,22
12/2/2015,23782,"24,684,867",0,39484,43065178,158096,138,,29
12/3/2015,33917,"24,718,784",0,59184,43124362,158130,348,,42
12/4/2015,34737,"24,753,521",0,61717,43186079,158157,549,,60
12/5/2015,26355,"24,779,876",0,56227,43242306,158183,1638,,66
12/6/2015,24942,"24,804,818",0,52485,43294791,158214,1321,,53
12/7/2015,34139,"24,838,957",0,60929,43355720,158251,554,,84
12/8/2015,35614,"24,874,571",0,59619,43415339,158284,411,,69
12/9/2015,35305,"24,909,876",0,59954,43475293,158317,355,,33
12/10/2015,39099,"24,948,975",0,69925,43545218,158357,638,,67
12/11/2015,39059,"24,988,034",0,72153,43617371,158388,822,,63
12/12/2015,31956,"25,019,990",0,68858,43686229,158427,2192,,51
12/13/2015,32001,"25,051,991",0,72863,43759092,158468,2470,,68
12/14/2015,32518,"25,084,509",0,57195,43816287,158529,606,,56
12/15/2015,38660,"25,123,169",0,67753,43884040,158572,606,,54
12/16/2015,35643,"25,158,812",0,61011,43945051,158617,436,,50
12/17/2015,21960,"25,180,772",0,35033,43980084,158643,120,,26
12/18/2015,30699,"25,211,471",0,51270,44031354,158671,384,,38
12/19/2015,17776,"25,229,247",0,30995,44062349,158692,527,,31
12/20/2015,17029,"25,246,276",0,30624,44092973,158732,604,,36
12/21/2015,29800,"25,276,076",0,54373,44147346,158772,494,,29
12/22/2015,22941,"25,299,017",0,39410,44186756,158793,274,,26
12/23/2015,14817,"25,313,834",0,28228,44214984,158825,172,,19
12/24/2015,18445,"25,332,279",0,35231,44250215,158844,660,,64
12/25/2015,12331,"25,344,610",0,37829,44288044,158883,2171,,84
12/26/2015,13912,"25,358,522",0,30690,44318734,158933,1021,,96
12/27/2015,13176,"25,371,698",0,30096,44348830,158993,1064,,83
12/28/2015,18889,"25,390,587",0,39889,44388719,159046,756,,69
12/29/2015,13347,"25,403,934",0,24451,44413170,159081,211,,36
12/30/2015,22476,"25,426,410",0,43736,44456906,159148,888,,57
12/31/2015,20375,"25,446,785",0,40032,44496938,159215,1072,,54
1/1/2016,11009,"25,457,794",0,24429,44521367,159362,919,,51
1/2/2016,14587,"25,472,381",0,29093,44550460,159403,877,,34
1/3/2016,15499,"25,487,880",0,29616,44580076,159459,784,,27
1/4/2016,19593,"25,507,473",0,36172,44616248,159502,166,,33
1/5/2016,18053,"25,525,526",0,32049,44648297,159534,121,,22
1/6/2016,24569,"25,550,095",0,40996,44689293,159564,265,,27
1/7/2016,27773,"25,577,868",0,45986,44735279,159588,318,,24
1/8/2016,28709,"25,606,577",0,47061,44782340,159621,364,,28
1/9/2016,20846,"25,627,423",0,37341,44819681,159654,632,,20
1/10/2016,14275,"25,641,698",0,25404,44845085,159682,391,,18
1/11/2016,22937,"25,664,635",0,37393,44882478,159731,155,,32
1/12/2016,25211,"25,689,846",0,38958,44921436,159761,151,,23
1/13/2016,21133,"25,710,979",0,31608,44953044,159792,82,,15
1/14/2016,23780,"25,734,759",0,37295,44990339,159813,123,,29
1/15/2016,28435,"25,763,194",0,45993,45036332,159841,379,,27
1/16/2016,19178,"25,782,372",0,35791,45072123,159885,803,,37
1/17/2016,12024,"25,794,396",0,20487,45092610,159910,387,,22
1/18/2016,12718,"25,807,114",0,19998,45112608,159931,123,,13
1/19/2016,17281,"25,824,395",0,26966,45139574,159957,64,,12
1/20/2016,23419,"25,847,814",0,35477,45175051,159972,126,,11
1/21/2016,23671,"25,871,485",0,36048,45211099,159991,133,,15
1/22/2016,20950,"25,892,435",0,31344,45242443,160004,115,,6
1/23/2016,0,"25,892,435",0,0,45242443,160005,0,,0
1/24/2016,0,"25,892,435",0,0,45242443,160013,0,,0
1/25/2016,0,"25,892,435",0,0,45242443,160020,0,,0
1/26/2016,0,"25,892,435",0,0,45242443,160028,0,,0
1/27/2016,6760,"25,899,195",0,13698,45256141,160039,54,,6
1/28/2016,11944,"25,911,139",0,22314,45278455,160053,81,,9
1/29/2016,16028,"25,927,167",0,26896,45305351,160064,118,,27
1/30/2016,12964,"25,940,131",0,23350,45328701,160084,328,,23
1/31/2016,16112,"25,956,243",0,31280,45359981,160118,533,,17
2/1/2016,24334,"25,980,577",0,42380,45402361,160160,202,,31
2/2/2016,28527,"26,009,104",0,47742,45450103,160189,280,,31
2/3/2016,16203,"26,025,307",0,24225,45474328,160216,63,,12
2/4/2016,27765,"26,053,072",0,47458,45521786,160247,304,,24
2/5/2016,13669,"26,066,741",0,25538,45547324,160257,102,,7
2/6/2016,16933,"26,083,674",0,38782,45586106,160280,586,,35
2/7/2016,17605,"26,101,279",0,31524,45617630,160316,622,,30
2/8/2016,19026,"26,120,305",0,28648,45646278,160335,80,,20
2/9/2016,22740,"26,143,045",0,40198,45686476,160364,156,,9
2/10/2016,22418,"26,165,463",0,38402,45724878,160395,130,,17
2/11/2016,18747,"26,184,210",0,27783,45752661,160425,87,,15
2/12/2016,16445,"26,200,655",0,27143,45779804,160450,104,,16
2/13/2016,6625,"26,207,280",0,11589,45791393,160459,46,,4
2/14/2016,4652,"26,211,932",0,6934,45798327,160468,78,,4
2/15/2016,5883,"26,217,815",0,8747,45807074,160480,43,,1
2/16/2016,14225,"26,232,040",0,27802,45834876,160505,53,,19
2/17/2016,23572,"26,255,612",0,38304,45873180,160528,182,,26
2/18/2016,22261,"26,277,873",0,34431,45907611,160550,202,,26
2/19/2016,21959,"26,299,832",0,35317,45942928,160568,268,,17
2/20/2016,24484,"26,324,316",0,53540,45996468,160618,1710,,50
2/21/2016,20052,"26,344,368",0,41645,46038113,160685,1228,,29
2/22/2016,28233,"26,372,601",0,48237,46086350,160749,455,,37
2/23/2016,16133,"26,388,734",0,26379,46112729,160784,62,,10
2/24/2016,9761,"26,398,495",0,14994,46127723,160814,38,,3
2/25/2016,25102,"26,423,597",0,42707,46170430,160849,237,,23
2/26/2016,22574,"26,446,171",0,36101,46206531,160887,254,,19
2/27/2016,17226,"26,463,397",0,37583,46244114,160910,706,,18
2/28/2016,25440,"26,488,837",0,61595,46305709,160982,2335,,43
2/29/2016,27957,"26,516,794",0,47933,46353642,161089,376,,58
3/1/2016,30509,"26,547,303",0,55160,46408802,161146,470,,66
3/2/2016,26195,"26,573,498",0,43535,46452337,161198,235,,35
3/3/2016,24061,"26,597,559",0,37848,46490185,161243,215,,22
3/4/2016,17369,"26,614,928",0,29100,46519285,161268,150,,16
3/5/2016,18023,"26,632,951",0,36875,46556160,161310,785,,46
3/6/2016,18832,"26,651,783",0,36377,46592537,161379,837,,40
3/7/2016,31492,"26,683,275",0,56232,46648769,161493,633,,58
3/8/2016,36521,"26,719,796",0,67958,46716727,161604,723,,98
3/9/2016,41489,"26,761,285",0,81662,46798389,161732,1226,,125
3/10/2016,42252,"26,803,537",0,82079,46880468,161867,1271,,111
3/11/2016,38193,"26,841,730",0,76636,46957104,161987,1266,,79
3/12/2016,32770,"26,874,500",0,81491,47038595,162086,3247,,105
3/13/2016,27549,"26,902,049",0,63214,47101809,162214,2216,,67
3/14/2016,10930,"26,912,979",0,16498,47118307,162289,70,,17
3/15/2016,31595,"26,944,574",0,57722,47176029,162380,582,,79
3/16/2016,36067,"26,980,641",0,68713,47244742,162482,930,,78
3/17/2016,35390,"27,016,031",0,65353,47310095,162583,785,,98
3/18/2016,34647,"27,050,678",0,69122,47379217,162670,933,,87
3/19/2016,24048,"27,074,726",0,49113,47428330,162733,1411,,69
3/20/2016,16676,"27,091,402",0,29737,47458067,162795,633,,40
3/21/2016,26414,"27,117,816",0,44457,47502524,162890,428,,57
3/22/2016,33496,"27,151,312",0,62248,47564772,163000,705,,99
3/23/2016,40981,"27,192,293",0,80289,47645061,163136,1279,,120
3/24/2016,36495,"27,228,788",0,67590,47712651,163216,1045,,101
3/25/2016,34091,"27,262,879",0,70525,47783176,163320,1684,,128
3/26/2016,27474,"27,290,353",0,67267,47850443,163407,2834,,108
3/27/2016,22481,"27,312,834",0,52462,47902905,163501,2080,,67
3/28/2016,20344,"27,333,178",0,35548,47938453,163589,375,,60
3/29/2016,31481,"27,364,659",0,55067,47993520,163681,588,,97
3/30/2016,33674,"27,398,333",0,61264,48054784,163770,769,,64
3/31/2016,38192,"27,436,525",0,79447,48134231,163865,1141,,91
4/1/2016,34448,"27,470,973",0,67595,48201826,163963,1113,0,82
4/2/2016,21838,"27,492,811",0,46206,48248032,164031,1193,0,63
4/3/2016,15321,"27,508,132",0,28615,48276647,164102,448,0,31
4/4/2016,12302,"27,520,434",0,20143,48296790,164167,49,0,19
4/5/2016,26236,"27,546,670",0,43723,48340513,164237,341,0,56
4/6/2016,29364,"27,576,034",0,48901,48389414,164310,443,0,37
4/7/2016,30400,"27,606,434",0,54591,48444005,164366,280,0,65
4/8/2016,30811,"27,637,245",0,53039,48497044,164425,542,0,51
4/9/2016,12698,"27,649,943",0,21151,48518195,164455,346,0,21
4/10/2016,23228,"27,673,171",0,49190,48567385,164536,1508,0,48
4/11/2016,32048,"27,705,219",0,59206,48626591,164632,668,0,82
4/12/2016,23765,"27,728,984",0,43504,48670095,164703,316,0,50
4/13/2016,37538,"27,766,522",0,71788,48741883,164790,761,0,106
4/14/2016,38502,"27,805,024",0,88278,48830161,164885,963,0,93
4/15/2016,39676,"27,844,700",0,86981,48917142,164996,1273,0,118
4/16/2016,36148,"27,880,848",0,102228,49019370,165139,3726,0,141
4/17/2016,38838,"27,919,686",0,115805,49135175,165354,4348,0,190
4/18/2016,43989,"27,963,675",0,102730,49237905,165576,1595,0,197
4/19/2016,46075,"28,009,750",0,107515,49345420,165812,1130,0,184
4/20/2016,44542,"28,054,292",0,104249,49449669,166002,1160,0,116
4/21/2016,45568,"28,099,860",0,104484,49554153,166153,1307,0,149
4/22/2016,48806,"28,148,666",0,113556,49667709,166319,4230,0,105
4/23/2016,33631,"28,182,297",0,96274,49763983,166462,3309,0,155
4/24/2016,37862,"28,220,159",0,115132,49879115,166692,4026,0,177
4/25/2016,42303,"28,262,462",0,100925,49980040,166902,1698,0,170
4/26/2016,34639,"28,297,101",0,75454,50055494,167048,741,0,97
4/27/2016,41931,"28,339,032",0,93272,50148766,167196,1395,0,110
4/28/2016,37428,"28,376,460",0,74857,50223623,167311,927,0,95
4/29/2016,34878,"28,411,338",0,78020,50301643,167439,1051,0,122
4/30/2016,38258,"28,449,596",0,110776,50412419,167638,4244,0,165
5/1/2016,10697,"28,460,293",0,29020,50441439,167721,260,0,24
5/2/2016,38536,"28,498,829",0,84418,50525857,167842,967,0,152
5/3/2016,22858,"28,521,687",0,57652,50583509,167987,350,0,45
5/4/2016,31619,"28,553,306",0,67962,50651471,168111,449,0,84
5/5/2016,39903,"28,593,209",0,80750,50732221,168262,970,0,107
5/6/2016,18860,"28,612,069",0,42069,50774290,168326,275,0,45
5/7/2016,31078,"28,643,147",0,78977,50853267,168427,2293,0,133
5/8/2016,31197,"28,674,344",0,84464,50937731,168582,2773,0,157
5/9/2016,45724,"28,720,068",0,103071,51040802,168779,1389,0,195
5/10/2016,44849,"28,764,917",0,89755,51130557,168979,876,0,133
5/11/2016,51181,"28,816,098",0,106139,51236696,169209,1531,0,147
5/12/2016,52273,"28,868,371",0,115823,51352519,169407,1971,0,169
5/13/2016,32391,"28,900,762",0,68317,51420836,169570,855,0,92
5/14/2016,42063,"28,942,825",0,108807,51529643,169769,4186,0,212
5/15/2016,28662,"28,971,487",0,64857,51594500,169933,1865,0,116
5/16/2016,42787,"29,014,274",0,94791,51689291,170102,1362,0,186
5/17/2016,43396,"29,057,670",0,80744,51770035,170276,1012,0,154
5/18/2016,44803,"29,102,473",0,93320,51863355,170465,1120,0,121
5/19/2016,49184,"29,151,657",0,104291,51967646,170680,1471,151,0
5/20/2016,52544,"29,204,201",0,118192,52085838,170960,2349,184,0
5/21/2016,30524,"29,234,725",0,72663,52158501,171147,2174,138,0
5/22/2016,37804,"29,272,529",0,98270,52256771,171349,3159,131,0
5/23/2016,48578,"29,321,107",0,109072,52365843,171680,1549,177,0
5/24/2016,34799,"29,355,906",0,68156,52433999,171898,696,98,0
5/25/2016,53441,"29,409,347",0,125803,52559802,172154,1702,191,0
5/26/2016,52134,"29,461,481",0,124751,52684553,172386,1646,195,0
5/27/2016,46943,"29,508,424",0,106768,52791321,172638,1988,221,0
5/28/2016,34233,"29,542,657",0,95897,52887218,172831,3634,296,0
5/29/2016,36881,"29,579,538",0,114069,53001287,173090,4820,161,0
5/30/2016,32627,"29,612,165",0,94241,53095528,173422,2782,134,0
5/31/2016,49774,"29,661,939",0,106059,53201587,174137,1492,212,0
6/1/2016,54662,"29,716,601",0,127143,53328730,174344,1513,156,0
6/2/2016,54401,"29,771,002",0,124918,53453648,174516,1649,162,0
6/3/2016,38975,"29,809,977",0,85292,53538940,174633,1023,118,0
6/4/2016,40973,"29,850,950",0,107610,53646550,174797,3824,159,0
6/5/2016,22395,"29,873,345",0,54320,53700870,174912,1133,57,0
6/6/2016,52130,"29,925,475",0,123879,53824749,175118,1861,208,0
6/7/2016,51761,"29,977,236",0,114761,53939510,175293,1331,127,0
6/8/2016,42063,"30,019,299",0,89460,54028970,175420,673,74,0
6/9/2016,52885,"30,072,184",0,127585,54156555,175557,1556,168,0
6/10/2016,53235,"30,125,419",0,119143,54275698,175697,2022,207,0
6/11/2016,40980,"30,166,399",0,111784,54387482,175901,3432,126,0
6/12/2016,40636,"30,207,035",0,117814,54505296,176087,3335,173,0
6/13/2016,49069,"30,256,104",0,110720,54616016,176273,1364,200,0
6/14/2016,54813,"30,310,917",0,116030,54732046,176467,1471,153,0
6/15/2016,55049,"30,365,966",0,122197,54854243,176711,1524,154,0
6/16/2016,46198,"30,412,164",0,100175,54954418,176865,1104,144,0
6/17/2016,54236,"30,466,400",0,121671,55076089,177053,2677,155,0
6/18/2016,48901,"30,515,301",0,143869,55219958,177210,6432,158,0
6/19/2016,45270,"30,560,571",0,137558,55357516,177370,5555,151,0
6/20/2016,52247,"30,612,818",0,119765,55477281,177660,1488,211,0
6/21/2016,53564,"30,666,382",0,116215,55593496,177895,1331,144,0
6/22/2016,55749,"30,722,131",0,119611,55713107,178168,1476,157,0
6/23/2016,53206,"30,775,337",0,115262,55828369,178354,1253,160,0
6/24/2016,54186,"30,829,523",0,123440,55951809,178545,2142,224,0
6/25/2016,43000,"30,872,523",0,123815,56075624,178715,4069,176,0
6/26/2016,42992,"30,915,515",0,117472,56193096,178893,3784,156,0
6/27/2016,47023,"30,962,538",0,100253,56293349,179061,1400,164,0
6/28/2016,49593,"31,012,131",0,99918,56393267,179215,1099,114,0
6/29/2016,54882,"31,067,013",0,114793,56508060,179403,1402,128,0
6/30/2016,54843,"31,121,856",0,125575,56633635,179625,1571,141,0
7/1/2016,39665,"31,161,521",0,82871,56716506,179756,1316,139,
7/2/2016,35835,"31,197,356",0,111151,56827657,179903,3596,314,
7/3/2016,35347,"31,232,703",0,111116,56938773,180016,4095,169,
7/4/2016,34859,"31,267,562",0,109745,57048518,180158,3826,155,
7/5/2016,43736,"31,311,298",0,92107,57140625,180338,1357,160,
7/6/2016,51336,"31,362,634",0,109240,57249865,180540,1288,153,
7/7/2016,48724,"31,411,358",0,99975,57349840,180725,1255,113,
7/8/2016,44400,"31,455,758",0,91632,57441472,180852,1258,152,
7/9/2016,38138,"31,493,896",0,107359,57548831,180990,2844,145,
7/10/2016,41985,"31,535,881",0,123282,57672113,181172,3280,137,
7/11/2016,52853,"31,588,734",0,122260,57794373,181381,1440,211,
7/12/2016,56515,"31,645,249",0,120414,57914787,181571,1472,192,
7/13/2016,55471,"31,700,720",0,121029,58035816,181748,1510,146,
7/14/2016,50345,"31,751,065",0,108541,58144357,181877,1326,126,
7/15/2016,48558,"31,799,623",0,104701,58249058,182016,1709,173,
7/16/2016,38405,"31,838,028",0,103429,58352487,182144,3281,122,
7/17/2016,41346,"31,879,374",0,120635,58473122,182314,3440,153,
7/18/2016,43681,"31,923,055",0,97216,58570338,182488,1062,154,
7/19/2016,54587,"31,977,642",0,116806,58687144,182624,1498,139,
7/20/2016,57213,"32,034,855",0,128799,58815943,182792,1601,158,
7/21/2016,54832,"32,089,687",0,128476,58944419,182950,1553,161,
7/22/2016,49185,"32,138,872",0,105666,59050085,183072,1701,176,
7/23/2016,37522,"32,176,394",0,101810,59151895,183177,2932,138,
7/24/2016,39634,"32,216,028",0,113680,59265575,183332,2966,114,
7/25/2016,35376,"32,251,404",0,85145,59350720,183473,920,150,
7/26/2016,52904,"32,304,308",0,108783,59459503,183595,1385,168,
7/27/2016,54148,"32,358,456",0,115744,59575247,183731,1403,132,
7/28/2016,50134,"32,408,590",0,98694,59673941,183846,1292,123,
7/29/2016,37693,"32,446,283",0,81355,59755296,183937,1441,162,
7/30/2016,27780,"32,474,063",0,72197,59827493,184039,2242,112,
7/31/2016,27651,"32,501,714",0,70377,59897870,184157,1641,82,
8/1/2016,49395,"32,551,109",0,101134,59999004,184325,1359,166,
8/2/2016,56744,"32,607,853",0,116187,60115191,184558,1636,181,
8/3/2016,56992,"32,664,845",0,118370,60233561,184766,1827,143,
8/4/2016,56587,"32,721,432",0,118563,60352124,184960,1778,148,
8/5/2016,53286,"32,774,718",0,116534,60468658,185186,2012,185,
8/6/2016,44209,"32,818,927",0,125188,60593846,185436,4159,153,
8/7/2016,43631,"32,862,558",0,116183,60710029,185682,3856,149,
8/8/2016,52251,"32,914,809",0,115847,60825876,185956,1753,184,
8/9/2016,56101,"32,970,910",0,114892,60940768,186223,1701,165,
8/10/2016,50100,"33,021,010",0,101761,61042529,186401,1158,109,
8/11/2016,47420,"33,068,430",0,93639,61136168,186596,1238,152,
8/12/2016,44729,"33,113,159",0,90685,61226853,186771,1467,144,
8/13/2016,38903,"33,152,062",0,100035,61326888,186990,3333,125,
8/14/2016,32961,"33,185,023",0,74055,61400943,187173,2154,91,
8/15/2016,49056,"33,234,079",0,107305,61508248,187394,1417,175,
8/16/2016,50411,"33,284,490",0,103010,61611258,187601,1295,164,
8/17/2016,53983,"33,338,473",0,113583,61724841,187820,1430,138,
8/18/2016,53209,"33,391,682",0,115041,61839882,187998,1459,163,
8/19/2016,51658,"33,443,340",0,110723,61950605,188186,1862,175,
8/20/2016,45808,"33,489,148",0,138864,62089469,188499,4385,167,
8/21/2016,35041,"33,524,189",0,96941,62186410,188725,2664,127,
8/22/2016,54201,"33,578,390",0,118995,62305405,188996,1679,192,
8/23/2016,58665,"33,637,055",0,127012,62432417,189297,1675,170,
8/24/2016,58134,"33,695,189",0,127066,62559483,189577,1597,160,
8/25/2016,53480,"33,748,669",0,111985,62671468,189856,1436,169,
8/26/2016,52026,"33,800,695",0,112005,62783473,190156,1878,197,
8/27/2016,45673,"33,846,368",0,120578,62904051,190480,3767,173,
8/28/2016,44639,"33,891,007",0,121056,63025107,190844,3560,159,
8/29/2016,53279,"33,944,286",0,115101,63140208,191255,1530,174,
8/30/2016,57392,"34,001,678",0,121098,63261306,191713,1510,160,
8/31/2016,57200,"34,058,878",0,118815,63380121,192380,1320,136,
9/1/2016,38174,"34,097,052",0,77415,63457536,192592,714,104,
9/2/2016,52999,"34,150,051",0,126790,63584326,192814,2314,252,
9/3/2016,41629,"34,191,680",0,117476,63701802,193055,4009,268,
9/4/2016,46020,"34,237,700",0,140347,63842149,193326,5467,185,
9/5/2016,45431,"34,283,131",0,118022,63960171,193677,3778,190,
9/6/2016,52432,"34,335,563",0,108743,64068914,194065,1018,178,
9/7/2016,60278,"34,395,841",0,130391,64199305,194396,1328,199,
9/8/2016,61551,"34,457,392",0,130259,64329564,194674,1511,179,
9/9/2016,56804,"34,514,196",0,118213,64447777,194908,1582,178,
9/10/2016,48454,"34,562,650",0,127252,64575029,195189,3549,229,
9/11/2016,52238,"34,614,888",0,136353,64711382,195499,3572,216,
9/12/2016,61083,"34,675,971",0,127447,64838829,195832,1620,225,
9/13/2016,64818,"34,740,789",0,135366,64974195,196122,1462,198,
9/14/2016,58928,"34,799,717",0,121511,65095706,196388,1369,157,
9/15/2016,67312,"34,867,029",0,140436,65236142,196637,1612,240,
9/16/2016,65257,"34,932,286",0,145454,65381596,196886,2047,225,
9/17/2016,59199,"34,991,485",0,154037,65535633,197163,5117,210,
9/18/2016,51685,"35,043,170",0,131788,65667421,197449,3191,159,
9/19/2016,34205,"35,077,375",0,67180,65734601,197620,555,101,
9/20/2016,64881,"35,142,256",0,135085,65869686,197880,1454,200,
9/21/2016,65453,"35,207,709",0,142356,66012042,198118,1566,182,
9/22/2016,67762,"35,275,471",0,146370,66158412,198363,1681,207,
9/23/2016,65499,"35,340,970",0,142458,66300870,198577,2053,248,
9/24/2016,53258,"35,394,228",0,137355,66438225,198827,3990,212,
9/25/2016,53563,"35,447,791",0,143312,66581537,199198,3871,169,
9/26/2016,61120,"35,508,911",0,128011,66709548,199480,1375,170,
9/27/2016,61334,"35,570,245",0,122347,66831895,199739,1175,150,
9/28/2016,59456,"35,629,701",0,120072,66951967,199989,931,107,
9/29/2016,55550,"35,685,251",0,104364,67056331,200201,808,131,
9/30/2016,21368,"35,706,619",0,45194,67101525,200447,175,20,
10/1/2016,39809,"35,746,428",0,91771,"67,193,296",200544,2017,133,
10/2/2016,41018,"35,787,446",0,100425,"67,293,721",200664,2147,119,
10/3/2016,56369,"35,843,815",0,116682,"67,410,403",200829,1514,183,
10/4/2016,60196,"35,904,011",0,123551,"67,533,954",200954,1035,144,
10/5/2016,65031,"35,969,042",0,126942,"67,660,896",201115,1240,160,
10/6/2016,67580,"36,036,622",0,137567,"67,798,463",201234,1580,205,
10/7/2016,65881,"36,102,503",0,142612,"67,941,075",201369,2398,222,
10/8/2016,34624,"36,137,127",0,86818,"68,027,893",201485,2002,160,
10/9/2016,21687,"36,158,814",0,46334,"68,074,227",201539,713,56,
10/10/2016,52248,"36,211,062",0,107487,"68,181,714",201664,2013,163,
10/11/2016,58754,"36,269,816",0,113228,"68,294,942",201761,1172,142,
10/12/2016,57497,"36,327,313",0,119851,"68,414,793",201880,1170,153,
10/13/2016,61209,"36,388,522",0,117523,"68,532,316",201984,1064,168,
10/14/2016,60561,"36,449,083",0,123000,"68,655,316",202090,1592,183,
10/15/2016,51991,"36,501,074",0,138233,"68,793,549",202215,3904,207,
10/16/2016,48866,"36,549,940",0,126550,"68,920,099",202343,3195,172,
10/17/2016,62649,"36,612,589",0,132131,"69,052,230",202502,1447,236,
10/18/2016,68224,"36,680,813",0,143635,"69,195,865",202653,1656,194,
10/19/2016,69758,"36,750,571",0,145347,"69,341,212",202772,1902,164,
10/20/2016,63668,"36,814,239",0,131686,"69,472,898",202893,1377,198,
10/21/2016,40865,"36,855,104",0,80787,"69,553,685",202960,724,102,
10/22/2016,25301,"36,880,405",0,55557,"69,609,242",203019,658,45,
10/23/2016,41462,"36,921,867",0,99878,"69,709,120",203137,2616,134,
10/24/2016,55254,"36,977,121",0,106893,"69,816,013",203269,1145,146,
10/25/2016,52667,"37,029,788",0,96848,"69,912,861",203349,716,102,
10/26/2016,52466,"37,082,254",0,103870,"70,016,731",203410,809,85,
10/27/2016,21054,"37,103,308",0,39660,"70,056,391",203449,101,23,
10/28/2016,46233,"37,149,541",0,89857,"70,146,248",203492,766,111,
10/29/2016,42513,"37,192,054",0,103274,"70,249,522",203579,2615,153,
10/30/2016,37760,"37,229,814",0,107572,"70,357,094",203697,2971,114,
10/31/2016,50071,"37,279,885",0,107875,"70,464,969",203787,1090,123,
11/1/2016,55944,"37,335,829",0,110056,"70,575,025",203888,868,105,
11/2/2016,62133,"37,397,962",0,133258,"70,708,283",203993,1242,141,
11/3/2016,59632,"37,457,594",0,124673,"70,832,956",204108,943,174,
11/4/2016,57867,"37,515,461",0,126507,"70,959,463",204195,1538,207,
11/5/2016,48687,"37,564,148",0,128639,"71,088,102",204301,3416,177,
11/6/2016,39413,"37,603,561",0,104186,"71,192,288",204428,2293,97,
11/7/2016,49883,"37,653,444",0,106484,"71,298,772",204520,972,119,
11/8/2016,56589,"37,710,033",0,123718,"71,422,490",204616,1137,107,
11/9/2016,38050,"37,748,083",0,75883,"71,498,373",204660,257,40,
11/10/2016,50863,"37,798,946",0,111472,"71,609,845",204728,813,139,
11/11/2016,45826,"37,844,772",0,105021,"71,714,866",204802,1248,165,
11/12/2016,34664,"37,879,436",0,86968,"71,801,834",204865,1916,114,
11/13/2016,36806,"37,916,242",0,95679,"71,897,513",204958,2076,95,
11/14/2016,48810,"37,965,052",0,113590,"72,011,103",205034,728,97,
11/15/2016,22884,"37,987,936",0,48797,72059900,205073,105,16,
11/16/2016,53328,"38,041,264",0,107831,72167731,205170,703,113,
11/17/2016,53889,"38,095,153",0,109418,72277149,205231,711,106,
11/18/2016,53370,"38,148,523",0,109802,72386951,205286,1051,125,
11/19/2016,41208,"38,189,731",0,98021,72484972,205376,2272,87,
11/20/2016,20616,"38,210,347",0,45772,72530744,205407,350,34,
11/21/2016,32964,"38,243,311",0,69754,72600498,205449,148,38,
11/22/2016,36723,"38,280,034",0,72592,72673090,205479,290,35,
11/23/2016,34462,"38,314,496",0,73005,72746095,205501,481,56,
11/24/2016,12122,"38,326,618",0,42343,72788438,205518,641,73,
11/25/2016,20980,"38,347,598",0,62444,72850882,205545,1011,67,
11/26/2016,23810,"38,371,408",0,65654,72916536,205572,1356,44,
11/27/2016,24076,"38,395,484",0,74381,72990917,205607,945,31,
11/28/2016,42086,"38,437,570",0,83300,73074217,205667,485,42,
11/29/2016,14584,"38,452,154",0,30989,73105206,205696,48,9,
11/30/2016,24434,"38,476,588",0,52424,73157630,205729,117,10,
12/1/2016,43233,"38,519,821",0,90239,73247869,205762,389,58,
12/2/2016,42358,"38,562,179",0,89092,73336961,205794,440,52,
12/3/2016,29853,"38,592,032",0,70853,73407814,205824,854,58,
12/4/2016,27454,"38,619,486",0,71729,73479543,205857,930,28,
12/5/2016,35927,"38,655,413",0,80214,73559757,205897,278,38,
12/6/2016,33325,"38,688,738",0,67187,73626944,205939,228,26,
12/7/2016,38010,"38,726,748",0,76605,73703549,205967,270,18,
12/8/2016,39621,"38,766,369",0,72219,73775768,205998,235,23,
12/9/2016,33540,"38,799,909",0,63950,73839718,206021,214,31,
12/10/2016,22379,"38,822,288",0,52716,73892434,206033,490,20,
12/11/2016,17798,"38,840,086",0,41740,73934174,206049,287,6,
12/12/2016,29035,"38,869,121",0,58701,73992875,206066,175,14,
12/13/2016,39023,"38,908,144",0,68858,74061733,206090,299,21,
12/14/2016,37799,"38,945,943",0,71798,74133531,206130,257,16,
12/15/2016,25002,"38,970,945",0,45840,74179371,206145,80,13,
12/16/2016,24484,"38,995,429",0,48288,74227659,206171,139,11,
12/17/2016,6993,"39,002,422",0,22363,74250022,206176,36,7,
12/18/2016,16295,"39,018,717",0,38459,74288481,206200,168,14,
12/19/2016,25648,"39,044,365",0,50405,74338886,206225,119,12,
12/20/2016,27677,"39,072,042",0,50408,74389294,206250,202,22,
12/21/2016,30611,"39,102,653",0,55746,74445040,206270,244,20,
12/22/2016,30874,"39,133,527",0,56441,74501481,206293,302,18,
12/23/2016,26335,"39,159,862",0,53318,74554799,206320,399,27,
12/24/2016,8014,"39,167,876",0,28033,74582832,206334,147,10,
12/25/2016,9919,"39,177,795",0,38209,74621041,206369,1052,43,
12/26/2016,10774,"39,188,569",0,32446,74653487,206400,315,27,
12/27/2016,25946,"39,214,515",0,61379,74714866,206450,960,68,
12/28/2016,23596,"39,238,111",0,52937,74767803,206476,619,38,
12/29/2016,13202,"39,251,313",0,29631,74797434,206503,104,8,
12/30/2016,21366,"39,272,679",0,45743,74843177,206543,641,49,
12/31/2016,15925,"39,288,604",0,46810,74889987,206585,798,33,
1/1/2017,16009,39304613,0,50761,74940748,206624,1237,,33
1/2/2017,8921,39313534,0,21545,74962293,206675,142,,15
1/3/2017,14198,39327732,0,25879,74988172,206728,42,,15
1/4/2017,34039,39361771,0,69966,75058138,206778,475,,29
1/5/2017,28393,39390164,0,52446,75110584,206845,214,,17
1/6/2017,24177,39414341,0,48964,75159548,206879,157,,17
1/7/2017,4425,39418766,0,23556,75183104,206892,21,,4
1/8/2017,6417,39425183,0,22756,75205860,206907,27,,2
1/9/2017,15856,39441039,0,35209,75241069,206933,30,,2
1/10/2017,23232,39464271,0,46216,75287285,206955,67,,12
1/11/2017,32419,39496690,0,63099,75350384,206981,208,,37
1/12/2017,39783,39536473,0,84763,75435147,207021,479,,30
1/13/2017,33611,39570084,0,75847,75510994,207059,373,,43
1/14/2017,13819,39583903,0,43090,75554084,207087,252,,33
1/15/2017,17384,39601287,0,50738,75604822,207120,476,,19
1/16/2017,24110,39625397,0,51664,75656486,207163,448,,30
1/17/2017,18646,39644043,0,40697,75697183,207198,63,,15
1/18/2017,30857,39674900,0,57978,75755161,207224,146,,17
1/19/2017,36561,39711461,0,72077,75827238,207262,391,,27
1/20/2017,26752,39738213,0,56479,75883717,207288,184,,19
1/21/2017,26610,39764823,0,64662,75948379,207336,957,,31
1/22/2017,20523,39785346,0,49368,75997747,207368,520,,25
1/23/2017,15822,39801168,0,37687,76035434,207399,54,,20
1/24/2017,13171,39814339,0,35619,76071053,207414,28,,5
1/25/2017,36931,39851270,0,71418,76142471,207453,301,,29
1/26/2017,33002,39884272,0,63750,76206221,207501,223,,28
1/27/2017,32394,39916666,0,70189,76276410,207540,231,,23
1/28/2017,21302,39937968,0,53955,76330365,207567,402,,25
1/29/2017,22527,39960495,0,62854,76393219,207620,585,,26
1/30/2017,29616,39990111,0,59975,76453194,207673,163,,32
1/31/2017,25169,40015280,0,48684,76501878,207706,62,,19
2/1/2017,35221,40050501,0,77639,76579517,207749,194,,22
2/2/2017,34517,40085018,0,70727,76650244,207793,216,,27
2/3/2017,29632,40114650,0,64701,76714945,207825,181,,32
2/4/2017,19204,40133854,0,45120,76760065,207861,413,,14
2/5/2017,20059,40153913,0,50532,76810597,207890,337,,19
2/6/2017,33415,40187328,0,72513,76883110,207930,305,,49
2/7/2017,23053,40210381,0,57760,76940870,207962,54,,17
2/8/2017,40428,40250809,0,90430,77031300,208011,483,,32
2/9/2017,0,40250809,0,0,77031300,208018,0,,0
2/10/2017,1997,40252806,0,8344,77039644,208030,15,,1
2/11/2017,8959,40261765,0,26272,77065916,208037,170,,13
2/12/2017,5801,40267566,0,26468,77092384,208054,26,,5
2/13/2017,23857,40291423,0,58710,77151094,208076,72,,18
2/14/2017,29668,40321091,0,78530,77229624,208099,154,,16
2/15/2017,32052,40353143,0,72383,77302007,208137,170,,30
2/16/2017,29120,40382263,0,63551,77365558,208163,104,,16
2/17/2017,28735,40410998,0,67530,77433088,208200,247,,37
2/18/2017,30571,40441569,0,99126,77532214,208258,2078,,114
2/19/2017,36963,40478532,0,125166,77657380,208347,3746,,122
2/20/2017,32292,40510824,0,91412,77748792,208436,1512,,75
2/21/2017,32643,40543467,0,84767,77833559,208516,308,,48
2/22/2017,38119,40581586,0,90651,77924210,208594,439,,36
2/23/2017,42434,40624020,0,98554,78022764,208658,828,,88
2/24/2017,47031,40671051,0,117155,78139919,208767,1534,,119
2/25/2017,33345,40704396,0,104309,78244228,208886,2035,,77
2/26/2017,24713,40729109,0,75196,78319424,208966,849,,33
2/27/2017,35984,40765093,0,80194,78399618,209035,388,,42
2/28/2017,41835,40806928,0,92642,78492260,209119,504,,60
3/1/2017,40592,40847520,0,85944,78578204,209229,393,,51
3/2/2017,35739,40883259,0,73839,78652043,209310,320,,44
3/3/2017,31105,40914364,0,68702,78720745,209370,292,,39
3/4/2017,15646,40930010,0,43108,78763853,209404,252,,14
3/5/2017,15919,40945929,0,50924,78814777,209451,312,,22
3/6/2017,32467,40978396,0,72776,78887553,209536,321,,39
3/7/2017,29683,41008079,0,63654,78951207,209587,181,,29
3/8/2017,43470,41051549,0,101573,79052780,209656,694,,55
3/9/2017,45251,41096800,0,99450,79152230,209728,764,,34
3/10/2017,18412,41115212,0,41971,79194201,209758,95,,15
3/11/2017,15185,41130397,0,48379,79242580,209781,183,,27
3/12/2017,13442,41143839,0,38114,79280694,209799,167,,9
3/13/2017,27417,41171256,0,58768,79339462,209827,205,,14
3/14/2017,0,41171256,0,0,79339462,209843,0,,0
3/15/2017,0,41171256,0,0,79339462,209859,0,,0
3/16/2017,0,41171256,0,0,79339462,209870,0,,0
3/17/2017,7098,41178354,0,25393,79364855,209888,151,,15
3/18/2017,4106,41182460,0,17446,79382301,209910,93,,6
3/19/2017,10550,41193010,0,33344,79415645,209943,339,,21
3/20/2017,27378,41220388,0,60363,79476008,210002,288,,21
3/21/2017,36824,41257212,0,78104,79554112,210073,479,,47
3/22/2017,26927,41284139,0,55713,79609825,210121,140,,15
3/23/2017,29885,41314024,0,74345,79684170,210160,291,,25
3/24/2017,34019,41348043,0,82681,79766851,210199,485,,39
3/25/2017,29647,41377690,0,86293,79853144,210267,1721,,60
3/26/2017,19893,41397583,0,55139,79908283,210318,546,,30
3/27/2017,26301,41423884,0,59614,79967897,210388,318,,40
3/28/2017,21590,41445474,0,46003,80013900,210448,91,,20
3/29/2017,42430,41487904,0,91525,80105425,210559,830,,97
3/30/2017,39746,41527650,0,91041,80196466,210623,669,,61
3/31/2017,6946,41534596,0,23462,80219928,210670,20,,5
4/1/2017,23849,41558445,0,67299,80287227,210739,767,,43
4/2/2017,39779,41598224,0,130087,80417314,210915,3639,,58
4/3/2017,43484,41641708,0,104217,80521531,211075,970,,68
4/4/2017,29990,41671698,0,63091,80584622,211171,183,,23
4/5/2017,47635,41719333,0,108281,80692903,211310,1192,,59
4/6/2017,18020,41737353,0,44411,80737314,211362,67,,12
4/7/2017,35779,41773132,0,81358,80818672,211440,456,,43
4/8/2017,35936,41809068,0,108886,80927558,211589,2719,,83
4/9/2017,43895,41852963,0,137240,81064798,211806,4390,,114
4/10/2017,50422,41903385,0,124356,81189154,212050,2164,,139
4/11/2017,57309,41960694,0,150222,81339376,212298,2699,,135
4/12/2017,51188,42011882,0,113959,81453335,212484,1493,,108
4/13/2017,52915,42064797,0,131228,81584563,212648,2388,,129
4/14/2017,52230,42117027,0,149382,81733945,212812,3451,,273
4/15/2017,42531,42159558,0,134526,81868471,212950,3981,,235
4/16/2017,48137,42207695,0,157912,82026383,213172,6143,,361
4/17/2017,53247,42260942,0,127619,82154002,213385,2019,,234
4/18/2017,53809,42314751,0,126129,82280131,213580,1624,,194
4/19/2017,45788,42360539,0,97587,82377718,213703,738,,55
4/20/2017,44260,42404799,0,108427,82486145,213819,1065,,172
4/21/2017,39868,42444667,0,92348,82578493,213913,1194,,129
4/22/2017,34596,42479263,0,101444,82679937,214028,5173,,102
4/23/2017,49106,42528369,0,142563,82822500,214278,4541,,420
4/24/2017,48692,42577061,0,103241,82925741,214462,1143,,123
4/25/2017,20332,42597393,0,47829,82973570,214552,201,,36
4/26/2017,37727,42635120,0,81859,83055429,214654,595,,109
4/27/2017,52035,42687155,0,122394,83177823,214793,1412,,266
4/28/2017,62199,42749354,0,163665,83341488,214965,2963,,458
4/29/2017,57701,42807055,0,180290,83521778,215219,5699,,562
4/30/2017,42928,42849983,0,125305,83647083,215455,2921,,340
5/1/2017,56218,42906201,0,136675,83783758,215724,1813,,311
5/2/2017,61205,42967406,0,142585,83926343,216017,1827,,309
5/3/2017,59251,43026657,0,141936,84068279,216239,1537,,247
5/4/2017,57428,43084085,0,144583,84212862,216436,1626,,239
5/5/2017,24009,43108094,0,58278,84271140,216535,355,,52
5/6/2017,46616,43154710,0,127879,84399019,216768,3349,,363
5/7/2017,34293,43189003,0,90625,84489644,216928,1921,,196
5/8/2017,51553,43240556,0,114260,84603904,217147,1230,,253
5/9/2017,56461,43297017,0,118257,84722161,217341,1179,,199
5/10/2017,58452,43355469,0,136080,84858241,217512,1362,,225
5/11/2017,57208,43412677,0,135699,84993940,217673,1313,,205
5/12/2017,56671,43469348,0,132477,85126417,217840,1784,,189
5/13/2017,5704,43475052,0,28193,85154610,217905,117,,0
5/14/2017,38729,43513781,0,114819,85269429,218120,2664,,222
5/15/2017,54715,43568496,0,129870,85399299,218356,1279,,185
5/16/2017,64504,43633000,0,157411,85556710,218690,1850,,283
5/17/2017,65791,43698791,0,153500,85710210,219023,1864,,241
5/18/2017,63753,43762544,0,149837,85860047,219304,1929,,270
5/19/2017,62143,43824687,0,145832,86005879,219564,2310,,275
5/20/2017,47858,43872545,0,135405,86141284,219776,3486,,251
5/21/2017,54873,43927418,0,160019,86301303,220097,4903,,287
5/22/2017,24627,43952045,0,61049,86362352,220269,218,,22
5/23/2017,60024,44012069,0,139680,86502032,220513,1579,,224
5/24/2017,60621,44072690,0,135482,86637514,220735,1558,,153
5/25/2017,17494,44090184,0,50743,86688257,220840,143,,27
5/26/2017,53763,44143947,0,133402,86821659,221049,2224,,306
5/27/2017,46533,44190480,0,145924,86967583,221271,4590,,511
5/28/2017,46724,44237204,0,151063,87118646,221515,5229,,374
5/29/2017,26321,44263525,0,75825,87194471,221745,1149,,77
5/30/2017,50192,44313717,0,114629,87309100,222057,962,,204
5/31/2017,59494,44373211,0,142097,87451197,222764,1596,,197
6/1/2017,67404,44440615,0,163063,87614260,222977,1957,,289
6/2/2017,66905,44507520,0,157299,87771559,223162,2315,,357
6/3/2017,56263,44563783,0,155712,87927271,223356,4627,,356
6/4/2017,40138,44603921,0,100571,88027842,223520,2270,,103
6/5/2017,55882,44659803,0,123795,88151637,223719,1286,,204
6/6/2017,41268,44701071,0,86679,88238316,223834,523,,89
6/7/2017,64452,44765523,0,149853,88388169,223969,1536,,258
6/8/2017,62652,44828175,0,132716,88520885,224131,1631,,266
6/9/2017,66504,44894679,0,156787,88677672,224289,2513,,313
6/10/2017,57086,44951765,0,150903,88828575,224455,4764,,296
6/11/2017,51427,45003192,0,140711,88969286,224654,3941,,179
6/12/2017,57870,45061062,0,133564,89102850,224889,1561,,201
6/13/2017,60920,45121982,0,129444,89232294,225078,1407,,179
6/14/2017,60510,45182492,0,137988,89370282,225231,1573,,218
6/15/2017,64761,45247253,0,144513,89514795,225430,1885,,227
6/16/2017,56401,45303654,0,128201,89642996,225556,1507,,177
6/17/2017,34899,45338553,0,83755,89726751,225683,2243,,209
6/18/2017,49469,45388022,0,138414,89865165,225864,3730,,295
6/19/2017,38308,45426330,0,88057,89953222,226025,878,,158
6/20/2017,64670,45491000,0,146794,90100016,226220,1781,,215
6/21/2017,67215,45558215,0,154525,90254541,226394,1666,,258
6/22/2017,66304,45624519,0,158453,90412994,226589,1818,,260
6/23/2017,55321,45679840,0,129797,90542791,226695,1585,,205
6/24/2017,52150,45731990,0,141282,90684073,226849,4277,,314
6/25/2017,54645,45786635,0,158625,90842698,227015,4527,,256
6/26/2017,62661,45849296,0,145321,90988019,227211,2024,,297
6/27/2017,64762,45914058,0,151112,91139131,227418,1697,,229
6/28/2017,67740,45981798,0,159263,91298394,227679,1893,,208
6/29/2017,64260,46046058,0,146419,91444813,227855,1703,,210
6/30/2017,58660,46104718,0,132583,91577396,228047,2024,,293
7/1/2017,36737,46141455,0,107126,91684522,228157,2828,,372
7/2/2017,43035,46184490,0,128397,91812919,228306,4314,,458
7/3/2017,48193,46232683,0,130240,91943159,228473,3243,,316
7/4/2017,49924,46282607,0,146441,92089600,228669,4929,,315
7/5/2017,60321,46342928,0,149487,92239087,228908,1886,,267
7/6/2017,62147,46405075,0,140767,92379854,229085,1646,,264
7/7/2017,44068,46449143,0,103656,92483510,229241,1283,,216
7/8/2017,55015,46504158,0,146438,92629948,229453,4138,,333
7/9/2017,57118,46561276,0,159914,92789862,229680,4471,,340
7/10/2017,60908,46622184,0,141463,92931325,229933,1546,,359
7/11/2017,61670,46683854,0,141463,93072788,230159,1269,,227
7/12/2017,61786,46745640,0,132874,93205662,230336,1376,,179
7/13/2017,56475,46802115,0,126527,93332189,230514,1322,,180
7/14/2017,31851,46833966,0,70477,93402666,230610,570,,101
7/15/2017,56499,46890465,0,148067,93550733,230772,4761,,378
7/16/2017,56833,46947298,0,153666,93704399,230981,4497,,308
7/17/2017,62555,47009853,0,141323,93845722,231225,1675,,289
7/18/2017,66234,47076087,0,144623,93990345,231416,1724,,243
7/19/2017,63916,47140003,0,143277,94133622,231603,1617,,267
7/20/2017,59665,47199668,0,131871,94265493,231741,1439,,229
7/21/2017,60074,47259742,0,136330,94401823,231882,1929,,304
7/22/2017,48013,47307755,0,124272,94526095,232049,3634,,332
7/23/2017,46945,47354700,0,117035,94643130,232212,3164,,249
7/24/2017,43793,47398493,0,104460,94747590,232359,989,,113
7/25/2017,65339,47463832,0,148542,94896132,232521,1549,,285
7/26/2017,70329,47534161,0,168603,95064735,232674,2054,,248
7/27/2017,65773,47599934,0,144443,95209178,232820,1666,,214
7/28/2017,63911,47663845,0,151514,95360692,232984,2293,,297
7/29/2017,52955,47716800,0,132509,95493201,233138,4085,,324
7/30/2017,59364,47776164,0,165423,95658624,233360,5214,,376
7/31/2017,64231,47840395,0,153123,95811747,233614,1862,,263
8/1/2017,66676,47907071,0,147654,95959401,233824,1813,,272
8/2/2017,56179,47963250,0,122622,96082023,233958,3291,,139
8/3/2017,66144,48029394,0,146858,96228881,234160,1849,,257
8/4/2017,56391,48085785,0,128749,96357630,234312,2212,,325
8/5/2017,58966,48144751,0,169511,96527141,234524,5299,,415
8/6/2017,56473,48201224,0,161492,96688633,234715,4686,,292
8/7/2017,23395,48224619,0,55927,96744560,234851,249,,34
8/8/2017,65228,48289847,0,145901,96890461,235084,1738,,331
8/9/2017,67874,48357721,0,170524,97060985,235283,1952,,300
8/10/2017,66245,48423966,0,151415,97212400,235457,1834,,262
8/11/2017,63134,48487100,0,147098,97359498,235623,2360,,358
8/12/2017,60531,48547631,0,173581,97533079,235890,5409,,405
8/13/2017,57511,48605142,0,162040,97695119,236098,4755,,337
8/14/2017,61460,48666602,0,139535,97834654,236328,1816,,294
8/15/2017,52460,48719062,0,105695,97940349,236504,948,,125
8/16/2017,68434,48787496,0,159032,98099381,236681,1905,,251
8/17/2017,66654,48854150,0,156810,98256191,236872,2087,,261
8/18/2017,36619,48890769,0,90704,98346895,236984,840,,124
8/19/2017,62440,48953209,0,186037,98532932,237324,5992,,461
8/20/2017,55438,49008647,0,147379,98680311,237518,4218,,313
8/21/2017,61055,49069702,0,138059,98818370,237710,1832,,277
8/22/2017,60541,49130243,0,133409,98951779,237878,1477,,260
8/23/2017,65069,49195312,0,141360,99093139,238057,1712,,219
8/24/2017,66306,49261618,0,151449,99244588,238257,1820,,315
8/25/2017,64217,49325835,0,156344,99400932,238406,2316,,325
8/26/2017,50111,49375946,0,132832,99533764,238546,3621,,214
8/27/2017,54594,49430540,0,145524,99679288,238771,4135,,278
8/28/2017,60885,49491425,0,133126,99812414,239016,1616,,272
8/29/2017,35151,49526576,0,67448,99879862,239163,424,,104
8/30/2017,65328,49591904,0,147325,100027187,239347,1760,,309
8/31/2017,64881,49656785,0,144852,100172039,239519,1727,,260
9/1/2017,54881,49711666,0,129382,100301421,239653,1775,,294
9/2/2017,37810,49749476,0,107949,100409370,239785,3359,,420
9/3/2017,30955,49780431,0,83988,100493358,239906,2394,,175
9/4/2017,55284,49835715,0,164623,100657981,240126,5298,,362
9/5/2017,65443,49901158,0,140362,100798343,240378,1607,,265
9/6/2017,42318,49943476,0,86395,100884738,240541,445,,90
9/7/2017,69571,50013047,0,148669,101033407,240750,1542,,356
9/8/2017,69616,50082663,0,154397,101187804,240903,1976,,322
9/9/2017,60187,50142850,0,150847,101338651,241108,4196,,272
9/10/2017,60750,50203600,0,154588,101493239,241329,4056,,301
9/11/2017,71964,50275564,0,166177,101659416,241563,1992,,276
9/12/2017,74623,50350187,0,161263,101820679,241775,1737,,238
9/13/2017,69616,50419803,0,146802,101967481,241991,1471,,199
9/14/2017,72128,50491931,0,150535,102118016,242211,1551,,244
9/15/2017,72361,50564292,0,160138,102278154,242393,2088,,323
9/16/2017,61077,50625369,0,156839,102434993,242552,4304,,297
9/17/2017,60003,50685372,0,156834,102591827,242748,3869,,229
9/18/2017,64207,50749579,0,138078,102729905,242968,1387,,190
9/19/2017,57977,50807556,0,115451,102845356,243128,914,,146
9/20/2017,71222,50878778,0,150377,102995733,243309,1385,,202
9/21/2017,67799,50946577,0,152463,103148196,243503,1690,,191
9/22/2017,70192,51016769,0,163114,103311310,243715,2315,,259
9/23/2017,62748,51079517,0,165582,103476892,243967,4821,,322
9/24/2017,57503,51137020,0,148926,103625818,244277,3681,,176
9/25/2017,69271,51206291,0,156367,103782185,244551,1537,,258
9/26/2017,71566,51277857,0,156779,103938964,244809,1359,,257
9/27/2017,69942,51347799,0,147977,104086941,245051,1268,,200
9/28/2017,70951,51418750,0,148394,104235335,245299,1490,,224
9/29/2017,67246,51485996,0,141709,104377044,245558,1875,,288
9/30/2017,50200,51536196,0,113613,104490657,245923,2694,,214
10/1/2017,55503,51591699,0,139011,104629668,246193,3511,,235
10/2/2017,65509,51657208,0,141748,104771416,246402,1408,,242
10/3/2017,69105,51726313,0,135800,104907216,246566,1258,,194
10/4/2017,71453,51797766,0,150324,105057540,246742,1377,,188
10/5/2017,70173,51867939,0,150437,105207977,246893,1365,,251
10/6/2017,70249,51938188,0,148395,105356372,247025,2104,,383
10/7/2017,63630,52001818,0,153928,105510300,247206,4996,,356
10/8/2017,41039,52042857,0,100790,105611090,247336,2233,,192
10/9/2017,38390,52081247,0,78912,105690002,247453,594,,84
10/10/2017,74117,52155364,0,155978,105845980,247615,2016,,312
10/11/2017,63587,52218951,0,126748,105972728,247767,1146,,161
10/12/2017,61244,52280195,0,123433,106096161,247896,1070,,169
10/13/2017,67016,52347211,0,136608,106232769,248038,1768,,308
10/14/2017,58771,52405982,0,142476,106375245,248167,3680,,347
10/15/2017,56529,52462511,0,137364,106512609,248382,3381,,276
10/16/2017,61729,52524240,0,125800,106638409,248552,997,,192
10/17/2017,64480,52588720,0,122345,106760754,248712,1030,,170
10/18/2017,70233,52658953,0,147842,106908596,248878,1202,,249
10/19/2017,72311,52731264,0,143664,107052260,249016,1491,,274
10/20/2017,72174,52803438,0,157255,107209515,249162,2246,,351
10/21/2017,65872,52869310,0,169402,107378917,249378,5093,,276
10/22/2017,62148,52931458,0,153444,107532361,249596,4596,,200
10/23/2017,69273,53000731,0,143899,107676260,249825,1659,,279
10/24/2017,48077,53048808,0,95599,107771859,249930,466,,82
10/25/2017,71284,53120092,0,142007,107913866,250090,1133,,246
10/26/2017,64002,53184094,0,123419,108037285,250187,973,,191
10/27/2017,69265,53253359,0,139481,108176766,250319,1991,,352
10/28/2017,61345,53314704,0,143571,108320337,250499,4306,,317
10/29/2017,9537,53324241,0,20810,108341147,250556,213,,8
10/30/2017,49246,53373487,0,95502,108436649,250681,771,,121
10/31/2017,60242,53433729,0,115329,108551978,250892,1076,,166
11/1/2017,60772,53494501,0,111304,108663282,250975,717,,125
11/2/2017,70810,53565311,0,144455,108807737,251060,1485,,291
11/3/2017,71817,53637128,0,147055,108954792,251163,2275,,335
11/4/2017,53433,53690561,0,120119,109074911,251269,3086,,243
11/5/2017,34943,53725504,0,76281,109151192,251349,1263,,80
11/6/2017,57606,53783110,0,116318,109267510,251433,1052,,133
11/7/2017,36361,53819471,0,69588,109337098,251487,643,,77
11/8/2017,54211,53873682,0,107852,109444950,251537,597,,95
11/9/2017,58416,53932098,0,113119,109558069,251591,837,,171
11/10/2017,38432,53970530,0,74794,109632863,251614,425,,82
11/11/2017,28142,53998672,0,55350,109688213,251657,832,,64
11/12/2017,32471,54031143,0,73187,109761400,251699,1191,,62
11/13/2017,38752,54069895,0,72112,109833512,251751,314,,47
11/14/2017,52278,54122173,0,95328,109928840,251802,493,,59
11/15/2017,54230,54176403,0,104590,110033430,251842,524,,70
11/16/2017,49737,54226140,0,93532,110126962,251884,521,,74
11/17/2017,48989,54275129,0,93476,110220438,251928,712,,74
11/18/2017,27745,54302874,0,58136,110278574,251965,872,,53
11/19/2017,31597,54334471,0,66078,110344652,252008,1020,,64
11/20/2017,45120,54379591,0,85295,110429947,252041,501,,49
11/21/2017,52448,54432039,0,95288,110525235,252075,960,,69
11/22/2017,32297,54464336,0,69530,110594765,252103,458,,64
11/23/2017,13705,54478041,0,32527,110627292,252115,806,,103
11/24/2017,23723,54501764,0,64012,110691304,252151,1129,,95
11/25/2017,30510,54532274,0,73542,110764846,252184,1995,,85
11/26/2017,27180,54559454,0,60652,110825498,252227,904,,63
11/27/2017,46732,54606186,0,99410,110924908,252277,553,,46
11/28/2017,51166,54657352,0,97329,111022237,252316,455,,58
11/29/2017,55290,54712642,0,107040,111129277,252365,638,,71
11/30/2017,51699,54764341,0,97110,111226387,252414,509,,83
12/1/2017,50708,54815049,0,99868,111326255,252473,695,,123
12/2/2017,38922,54853971,0,83660,111409915,252514,1513,,100
12/3/2017,33728,54887699,0,77915,111487830,252561,1037,,66
12/4/2017,49630,54937329,0,92142,111579972,252618,649,,63
12/5/2017,41792,54979121,0,85008,111664980,252686,381,,57
12/6/2017,46335,55025456,0,87328,111752308,252724,368,,55
12/7/2017,45367,55070823,0,94653,111846961,252761,427,,65
12/8/2017,41330,55112153,0,81217,111928178,252791,443,,58
12/9/2017,10804,55122957,0,20955,111949133,252811,112,,15
12/10/2017,19815,55142772,0,43621,111992754,252830,287,,26
12/11/2017,41838,55184610,0,81071,112073825,252869,456,,38
12/12/2017,42620,55227230,0,88499,112162324,252915,262,,42
12/13/2017,32623,55259853,0,60051,112222375,252942,155,,20
12/14/2017,27494,55287347,0,49648,112272023,252960,134,,10
12/15/2017,22944,55310291,0,41598,112313621,252980,130,,9
12/16/2017,19060,55329351,0,38766,112352387,252992,240,,24
12/17/2017,22403,55351754,0,49790,112402177,253011,343,,27
12/18/2017,40168,55391922,0,79914,112482091,253054,409,,34
12/19/2017,49503,55441425,0,97301,112579392,253087,541,,42
12/20/2017,41461,55482886,0,78833,112658225,253142,422,,40
12/21/2017,37592,55520478,0,70297,112728522,253180,386,,47
12/22/2017,34338,55554816,0,62387,112790909,253212,506,,23
12/23/2017,9608,55564424,0,24205,112815114,253228,112,,10
12/24/2017,13215,55577639,0,37985,112853099,253250,492,,39
12/25/2017,6479,55584118,0,26767,112879866,253293,439,,27
12/26/2017,14113,55598231,0,32919,112912785,253324,220,,29
12/27/2017,16365,55614596,0,31793,112944578,253346,234,,33
12/28/2017,13419,55628015,0,34438,112979016,253365,121,,17
12/29/2017,13759,55641774,0,29284,113008300,253395,177,,17
12/30/2017,5956,55647730,0,13910,113022210,253407,53,,10
12/31/2017,6569,55654299,0,18326,113040536,253443,94,,2
